{
	"x": 1,
	"y": 0,

	"tiles": [
		3,2,2,2,2,2,2,2,2,2,
		3,3,2,2,2,2,2,2,2,2,
		3,3,3,2,2,2,2,2,2,2,
		2,2,2,2,2,2,2,2,2,2,
		2,2,2,1,1,1,1,1,1,1,
		1,1,1,1,1,1,1,1,1,1,
		1,1,1,1,1,1,1,1,1,1,
		1,1,1,1,1,1,1,1,1,1,
		1,1,1,1,1,1,1,1,1,1,
		1,1,1,1,1,1,1,1,1,1
	]
}