{
	"x": 0,
	"y": 0,

	"data": [
		2,2,2,2,2,2,3,3,3,3,
		2,2,2,2,2,2,3,3,3,3,
		2,2,2,2,2,4,4,3,3,3,
		2,2,2,2,4,4,4,4,2,2,
		2,2,2,2,4,4,4,4,4,2,
		2,2,2,2,2,4,4,4,1,1,
		1,1,1,1,1,1,4,4,4,1,
		1,1,1,1,1,1,1,4,1,1,
		0,0,1,1,1,1,1,1,1,1,
		0,0,0,1,1,1,1,1,1,1
	]
}