{
	"x": 0,
	"y": 0,

	"data": [
		1,1,1,1,1,1,2,2,2,2,
		1,1,1,1,1,1,2,2,2,2,
		1,1,1,1,1,3,3,2,2,2,
		1,1,1,1,3,3,3,3,1,1,
		1,1,1,1,3,3,3,3,3,1,
		1,1,1,1,1,3,3,3,0,0,
		0,0,0,0,0,0,3,3,3,0,
		0,0,0,0,0,0,0,3,0,0,
		0,0,0,0,0,0,0,0,0,0,
		0,0,0,0,0,0,0,0,0,0
	]
}