{
	"x": 2,
	"y": 1,

	"tiles": [
		3,2,2,2,2,2,2,2,2,2,
		3,3,2,2,2,2,2,2,2,2,
		3,3,3,2,2,2,2,2,2,2,
		2,2,2,2,2,2,2,2,2,2,
		2,2,2,1,1,1,1,1,1,1,
		1,1,1,1,1,1,1,1,1,1,
		1,1,1,1,1,1,1,1,1,1,
		1,1,1,1,1,1,1,1,1,1,
		1,1,1,1,1,1,1,1,1,1,
		1,1,1,1,1,1,1,1,1,1
	]
}